____G__X_____X__
___XXX____XXXX__
XX____XX___X____
__XXXX______X__X
___X____XX____XX
__S__X_____XXX__