_____S__X_____X_______X_____XXX_
___XXX____XXXX_____X____XX____XX
XX____XX___X______XX_XX_____X__X
__XXXX___X__X__XXX____XX___X____
___X____XX____XX___XXX____XXXX__
____X_____XXX______X__X_____X___
____X__X_____X______X_____XXX__X
___XXX____XXXX_____X__G_XX____XX